AND -> and
BREAK -> BREAK
IF -> if
CONST -> const
CASE -> Case
CATCH -> catch
CONTINUE -> continue
DEFAULT -> default
DELETE -> delete
ELSE -> else
FALSE -> false
FINALLY -> finally
FOR -> for
FUNCTION -> function
LET -> let
NULL -> null
RETURN -> return
SWITCH -> switch
THROW -> throw
TRY -> try
TRUE -> true
VAR -> var
WHILE -> while
LBRACKET -> lbracket
RBRACKET -> Rbracket
NEWLINE -> newline
EQUAL -> equal
PLUS -> plus
MINUS -> minus
TIMES -> times
MOD -> mod
LCURLY -> lcurly
RCURLY -> rcurly
LSQUARE -> lsquare
RSQUARE -> rsquare
SEMICOLON -> semicolon
COLON -> colon
COMMA -> comma
DOT -> dot
NOT -> not
OR -> or
GREATER -> greater
LESS -> less
GREATEREQUAL -> greaterequal
LESSEQUAL -> lessequal
PLUSPLUS -> plusplus
MINUSMINUS -> minusminus
ANDAND -> andand
OROR -> oror
STRING -> string
INT -> int
CHAR -> char
COMMENT -> comment
UNDERSCORE -> underscore
PLUSEQUAL -> plusequal
MINUSEQUAL -> minusequal
TIMESEQUAL -> timesequal
DIVEQUAL -> divequal
